R 1080 768

NO ./Textures/bluestone.xpm
SO ./Textures/greystone.xpm
WE ./Textures/redbrick.xpm
EA ./Textures/wood.xpm

S ./Textures/barrel.xpm
F 200,0,0
C 17,15,17

1111111
10000001
1111100111
    10022011
1111000111
10000001
100S0001
10000001
11111111