R 1550 800

NO ./Textures/greystone.xpm
SO ./Textures/greystone.xpm
WE ./Textures/redbrick.xpm
EA ./Textures/wood.xpm

S ./Textures/barrel.xpm
F 250,0,0
C 17,220,0    

11111111
10000001
11000020111
1000000000011111
111100000000001
100200000200001
10000000020001
100N000000001
1111111111111