R 1080 768

NO ./Textures/greystone.xpm
SO ./Textures/greystone.xpm
WE ./Textures/redbrick.xpm
EA ./Textures/wood.xpm

S ./Textures/barrel.xpm
F 200,0,0
C 17,15,17

11111111
10000001
1111100111
    10000011
11110001111111
100200000200001
10000011111111
100N000000001
1111111111111