R 1550 800

NO ./Textures/greystone.xpm
SO ./Textures/greystone.xpm
WE ./Textures/redbrick.xpm
EA ./Textures/wood.xpm

S ./Textures/barrel.xpm
F 250,0,0
C 17,220,0    


11111111
10000001
11000020111111
1000000000000011
111100100001111
100200002001
1000000020111
100N0000000001
11111111111111