R 1080 768

NO ./tex/bluestone.png
SO ./tex/greystone.png
WE ./tex/redbrick.png
EA ./tex/wood.png

S ./tex/barrel.png
F 111,111,111
C 17,15,17

1111111
10000001
1111100111
    10022011
1111000111
10000001
1000N001
10000001
11111111