R 1920 1080

NO ./Textures/bluestone.xpm
SO ./Textures/greystone.xpm
WE ./Textures/redbrick.xpm
EA ./Textures/wood.xpm

S ./Textures/barrel.xpm
F 250,0,0
C 17,220,0    

1111111111111111111111111
1000000000110000000000001
1011000001110000002000001
10010000000000000000000011111111
111111111011000001110000000000001
100000000011000001110111100011111
11110111111111011100000010001
11110111111111011101010010001
11000000110101011100000010001
10002000000000001100000010001
10000000000000001101010010001
11000001110101011111011110N0111
1111111111111111111111111111111